111111111111111111111111
100000000000000000010001
1000P0000000000000000001
100010000000000000000001
1000100000000000000C0001
100010000000010000000001
100010000000010000000001
10000000000001E000000001
100000000000011100000001
100100000000000000C00001
100100000000000000000001
1C0100000000000000CCC111
111111111111111111111111
